AppModules::Distribution::DistributedAppModule	../shopify/components/apps/app/models/app_modules/distribution/distributed_app_module.rb	apps
AppModules::Distribution::Installations::ReconcilableAppModule	../shopify/components/apps/app/models/app_modules/distribution/installations/reconcilable_app_module.rb	apps
AppModules::Distribution::Installations::ReconcilableInstallation	../shopify/components/apps/app/models/app_modules/distribution/installations/reconcilable_installation.rb	apps
AppModules::Management::AppModule	../shopify/components/apps/app/models/app_modules/management/app_module.rb	apps
ShopifyVM::Domain::AppBridge	../shopify/components/apps/app/models/shopify_vm/domain/app_bridge.rb	apps
ShopifyVM::Domain::FunctionRegistry::Change	../shopify/components/apps/app/models/shopify_vm/domain/function_registry.rb	apps
ShopifyVM::Domain::FunctionRegistry::PageStats	../shopify/components/apps/app/models/shopify_vm/domain/function_registry.rb	apps
ShopifyVM::Domain::FunctionRegistry::Response	../shopify/components/apps/app/models/shopify_vm/domain/function_registry.rb	apps
Apps::Deployments::Errors::Details::AppDetails	../shopify/components/apps/app/public/apps/deployments/errors/details/app_details.rb	apps
Apps::Deployments::Errors::Details::DeploymentDetails	../shopify/components/apps/app/public/apps/deployments/errors/details/deployment_details.rb	apps
Apps::Extensions::Errors::Catastrophic::EventError	../shopify/components/apps/app/public/apps/extensions/errors/catastrophic/event_error.rb	apps
Apps::Extensions::Errors::Catastrophic::InternalError	../shopify/components/apps/app/public/apps/extensions/errors/catastrophic/internal_error.rb	apps
Apps::Extensions::Errors::Catastrophic::PluginError	../shopify/components/apps/app/public/apps/extensions/errors/catastrophic/plugin_error.rb	apps
Apps::Extensions::Errors::Catastrophic::UnknownError	../shopify/components/apps/app/public/apps/extensions/errors/catastrophic/unknown_error.rb	apps
Apps::Extensions::Errors::Details::ExtensionDetails	../shopify/components/apps/app/public/apps/extensions/errors/details/extension_details.rb	apps
Apps::Extensions::Errors::Details::IdentifierDetails	../shopify/components/apps/app/public/apps/extensions/errors/details/identifier_details.rb	apps
Apps::Extensions::Errors::Details::RegistrationDetails	../shopify/components/apps/app/public/apps/extensions/errors/details/registration_details.rb	apps
Apps::Extensions::Errors::Details::VersionDetails	../shopify/components/apps/app/public/apps/extensions/errors/details/version_details.rb	apps
Apps::Extensions::Errors::Errors	../shopify/components/apps/app/public/apps/extensions/errors/errors.rb	apps
Apps::Extensions::Errors::User::NotFound	../shopify/components/apps/app/public/apps/extensions/errors/user/not_found.rb	apps
Apps::Extensions::Errors::User::ValidationError	../shopify/components/apps/app/public/apps/extensions/errors/user/validation_error.rb	apps
Extensibility::ConfigurationDefinition::Nodes::ConfigurationDefinitionError	../shopify/components/apps/app/public/extensibility/configuration_definition/nodes/configuration_definition_error.rb	apps
Extensibility::ConfigurationDefinition::Nodes::ConfigurationValidationError	../shopify/components/apps/app/public/extensibility/configuration_definition/nodes/configuration_validation_error.rb	apps
ExternalCalls::Context	../shopify/components/apps/app/services/external_calls/context.rb	apps
ExternalCalls::HttpRequest	../shopify/components/apps/app/services/external_calls/http_request.rb	apps
ExternalCalls::HttpRequest::Policy	../shopify/components/apps/app/services/external_calls/http_request.rb	apps
ExternalCalls::HttpResponse	../shopify/components/apps/app/services/external_calls/http_response.rb	apps
Checkouts::Core::BrandingSettingsSchema::ButtonHovered	../shopify/components/checkouts/app/public/checkouts/core/branding_settings_schema.rb	checkouts
Checkouts::Core::BrandingSettingsSchema::Color	../shopify/components/checkouts/app/public/checkouts/core/branding_settings_schema.rb	checkouts
Checkouts::Core::BrandingSettingsSchema::ColorGroup	../shopify/components/checkouts/app/public/checkouts/core/branding_settings_schema.rb	checkouts
Checkouts::Core::BrandingSettingsSchema::ColorRoles	../shopify/components/checkouts/app/public/checkouts/core/branding_settings_schema.rb	checkouts
Checkouts::Core::BrandingSettingsSchema::ColorPalette	../shopify/components/checkouts/app/public/checkouts/core/branding_settings_schema.rb	checkouts
Checkouts::Core::BrandingSettingsSchema::ColorGlobal	../shopify/components/checkouts/app/public/checkouts/core/branding_settings_schema.rb	checkouts
Checkouts::Core::BrandingSettingsSchema::ControlColorRoles	../shopify/components/checkouts/app/public/checkouts/core/branding_settings_schema.rb	checkouts
Checkouts::Core::BrandingSettingsSchema::ButtonColorRoles	../shopify/components/checkouts/app/public/checkouts/core/branding_settings_schema.rb	checkouts
Checkouts::Core::BrandingSettingsSchema::ColorScheme	../shopify/components/checkouts/app/public/checkouts/core/branding_settings_schema.rb	checkouts
Checkouts::Core::BrandingSettingsSchema::ColorSchemes	../shopify/components/checkouts/app/public/checkouts/core/branding_settings_schema.rb	checkouts
Checkouts::Core::BrandingSettingsSchema::Font	../shopify/components/checkouts/app/public/checkouts/core/branding_settings_schema.rb	checkouts
Checkouts::Core::BrandingSettingsSchema::TypographyStyle	../shopify/components/checkouts/app/public/checkouts/core/branding_settings_schema.rb	checkouts
Checkouts::Core::BrandingSettingsSchema::TypographyStyleGlobal	../shopify/components/checkouts/app/public/checkouts/core/branding_settings_schema.rb	checkouts
Checkouts::Core::BrandingSettingsSchema::Colors	../shopify/components/checkouts/app/public/checkouts/core/branding_settings_schema.rb	checkouts
Checkouts::Core::BrandingSettingsSchema::HeadingLevel	../shopify/components/checkouts/app/public/checkouts/core/branding_settings_schema.rb	checkouts
CheckoutPlatform::ReceiptActionTimeout	../shopify/components/checkouts/checkout_platform/app/models/checkout_platform/receipt_action_timeout.rb	checkouts
AbandonedCart::AbstractCartItem	../shopify/components/checkouts/core/app/models/abandoned_cart/abstract_cart_item.rb	checkouts
Checkouts::One::ScriptsV1::Source::Customer	../shopify/components/checkouts/one/app/models/checkouts/one/scripts_v1/source.rb	checkouts
Checkouts::One::Web::Artifact::CartCheckoutValidation	../shopify/components/checkouts/one/app/models/checkouts/one/web/artifact/cart_checkout_validation.rb	checkouts
Checkouts::One::Web::Policies::Artifact::CartCheckoutValidationPolicy::Extension	../shopify/components/checkouts/one/app/models/checkouts/one/web/policies/artifact/cart_checkout_validation_policy.rb	checkouts
Checkouts::One::Web::PresentmentMerchandiseTerms::DiscountAllocation	../shopify/components/checkouts/one/app/models/checkouts/one/web/presentment_merchandise_terms.rb	checkouts
Checkouts::One::Web::PresentmentMerchandiseTerms::TaxAllocation	../shopify/components/checkouts/one/app/models/checkouts/one/web/presentment_merchandise_terms.rb	checkouts
Checkouts::One::Web::PresentmentMerchandiseTerms::MerchandiseLineComponent	../shopify/components/checkouts/one/app/models/checkouts/one/web/presentment_merchandise_terms.rb	checkouts
Checkouts::One::Web::PresentmentMerchandiseTerms::StandardLine	../shopify/components/checkouts/one/app/models/checkouts/one/web/presentment_merchandise_terms.rb	checkouts
Checkouts::One::MerchandiseItemHashGenerator::GroupHashKey	../shopify/components/checkouts/one/app/services/checkouts/one/merchandise_item_hash_generator.rb	checkouts
Delivery::Domain::FindDeliveryItemsForDeliverable::DeliveryItemDetails	../shopify/components/delivery/app/services/delivery/domain/find_delivery_items_for_deliverable.rb	delivery
DraftOrder::ShippingLineIntent	../shopify/components/draft_orders/app/models/draft_order/shipping_line_intent.rb	draft_orders
DraftOrders::Snapshots::Relationship::Schema	../shopify/components/draft_orders/app/services/draft_orders/snapshots/relationship/schema.rb	draft_orders
Inventory::Allocator::Allocation	../shopify/components/inventory/app/models/inventory/allocator/allocation.rb	inventory
Inventory::Allocator::AllocationRequest	../shopify/components/inventory/app/models/inventory/allocator/allocation_request.rb	inventory
Inventory::Allocator::AllocationRequestGroup	../shopify/components/inventory/app/models/inventory/allocator/allocation_request_group.rb	inventory
Inventory::Allocator::AllocationRequestGroup::Policy::Unconstrained	../shopify/components/inventory/app/models/inventory/allocator/allocation_request_group.rb	inventory
Inventory::Allocator::AllocationRequestGroup::Policy::SingleLocationFromList	../shopify/components/inventory/app/models/inventory/allocator/allocation_request_group.rb	inventory
Inventory::Quantities::MoveTerminal	../shopify/components/inventory/app/models/inventory/quantities.rb	inventory
Inventory::Quantities::Move	../shopify/components/inventory/app/models/inventory/quantities.rb	inventory
MarketplacePayments::CalculatedSalesTax	../shopify/components/marketplaces/marketplace_payments/app/models/marketplace_payments/calculated_sales_tax.rb	marketplaces
MarketplacePayments::Configuration	../shopify/components/marketplaces/marketplace_payments/app/models/marketplace_payments/configuration.rb	marketplaces
MarketplacePayments::Feature	../shopify/components/marketplaces/marketplace_payments/app/models/marketplace_payments/feature.rb	marketplaces
MarketplacePayments::OrderFee	../shopify/components/marketplaces/marketplace_payments/app/models/marketplace_payments/order_fee.rb	marketplaces
MarketplacePayments::OrderFeeReversal	../shopify/components/marketplaces/marketplace_payments/app/models/marketplace_payments/order_fee_reversal.rb	marketplaces
MarketplacePayments::OrderTax	../shopify/components/marketplaces/marketplace_payments/app/models/marketplace_payments/order_tax.rb	marketplaces
MarketplacePayments::OrderTaxReversal	../shopify/components/marketplaces/marketplace_payments/app/models/marketplace_payments/order_tax_reversal.rb	marketplaces
MarketplacePayments::PartnerStripeAccount	../shopify/components/marketplaces/marketplace_payments/app/models/marketplace_payments/partner_stripe_account.rb	marketplaces
MarketplacePayments::Outputs::Feature	../shopify/components/marketplaces/marketplace_payments/app/public/marketplace_payments/outputs/feature.rb	marketplaces
MarketplacePayments::Outputs::OrderFee	../shopify/components/marketplaces/marketplace_payments/app/public/marketplace_payments/outputs/order_fee.rb	marketplaces
MarketplacePayments::Outputs::OrderFeeReversal	../shopify/components/marketplaces/marketplace_payments/app/public/marketplace_payments/outputs/order_fee_reversal.rb	marketplaces
MarketplacePayments::Outputs::WebhookFeature	../shopify/components/marketplaces/marketplace_payments/app/public/marketplace_payments/outputs/webhook_feature.rb	marketplaces
MarketsPro::PhaseBuilder::EligibilityServiceFacade::Response	../shopify/components/markets/app/services/markets_pro/phase_builder/eligibility_service_facade.rb	markets
Merchandising::PricingEngine::SimplePriceable	../shopify/components/merchandising/app/models/merchandising/pricing_engine/simple_priceable.rb	merchandising
Merchandising::ProductVariants::GroupRelationshipData	../shopify/components/merchandising/app/models/merchandising/product_variants/group_relationship_data.rb	merchandising
Merchandising::PricingEngine::QuantityPriceBreakResponse	../shopify/components/merchandising/app/services/merchandising/pricing_engine/quantity_price_break_response.rb	merchandising
Merchandising::ProductTaxonomies::ProductTaxonomyInput	../shopify/components/merchandising/app/services/merchandising/product_taxonomies/product_taxonomy_input.rb	merchandising
Merchandising::VolumePricing::Service::QuantityPriceBreakToAddInput	../shopify/components/merchandising/app/services/merchandising/volume_pricing/service.rb	merchandising
Merchandising::VolumePricing::Service::QuantityPriceBreakToAddInput::Error	../shopify/components/merchandising/app/services/merchandising/volume_pricing/service.rb	merchandising
Merchandising::VolumePricing::Service::QuantityRulesToAddInput	../shopify/components/merchandising/app/services/merchandising/volume_pricing/service.rb	merchandising
Merchandising::VolumePricing::Service::QuantityRulesToAddInput::Error	../shopify/components/merchandising/app/services/merchandising/volume_pricing/service.rb	merchandising
Merchandising::VolumePricing::Service::PricesToAddInput	../shopify/components/merchandising/app/services/merchandising/volume_pricing/service.rb	merchandising
Merchandising::VolumePricing::Service::PricesToAddInput::Error	../shopify/components/merchandising/app/services/merchandising/volume_pricing/service.rb	merchandising
Merchandising::VolumePricing::Service::QuantityPriceBreakToDeleteInput::Error	../shopify/components/merchandising/app/services/merchandising/volume_pricing/service.rb	merchandising
Merchandising::VolumePricing::Service::QuantityRulesToDeleteInput::Error	../shopify/components/merchandising/app/services/merchandising/volume_pricing/service.rb	merchandising
Merchandising::VolumePricing::Service::PricesToDeleteInput::Error	../shopify/components/merchandising/app/services/merchandising/volume_pricing/service.rb	merchandising
Merchandising::VolumePricing::Service::Errors	../shopify/components/merchandising/app/services/merchandising/volume_pricing/service.rb	merchandising
CustomerBehaviourApi::AttributedEvent	../shopify/components/merchant_marketing/metrics/app/graph_clients/customer_behaviour_api/attributed_event.rb	merchant_marketing
CustomerIdentity	../shopify/components/merchant_marketing/metrics/app/graph_clients/customer_identity.rb	merchant_marketing
Attribution::AttributedWindows	../shopify/components/merchant_marketing/metrics/app/models/attribution/attributed_windows.rb	merchant_marketing
Attribution::PersistableAttributedSession	../shopify/components/merchant_marketing/metrics/app/models/attribution/persistable_attributed_session.rb	merchant_marketing
OnlineStore::Datasources::Context::Inline	../shopify/components/online_store/app/models/online_store/datasources/context.rb	online_store
OnlineStore::Datasources::Datasource	../shopify/components/online_store/app/models/online_store/datasources/datasource.rb	online_store
OnlineStore::Datasources::MetafieldDefinitionsBatchLoader::Query	../shopify/components/online_store/app/models/online_store/datasources/metafield_definitions_batch_loader.rb	online_store
OnlineStore::Datasources::Parser::AccessPath	../shopify/components/online_store/app/models/online_store/datasources/parser.rb	online_store
OnlineStore::Datasources::Types::Property	../shopify/components/online_store/app/models/online_store/datasources/types/property.rb	online_store
OnlineStore::Datasources::MetafieldPath	../shopify/components/online_store/app/models/online_store/datasources.rb	online_store
DefaultToShopPayBrandedButtonOnPdpV4::Subject	../shopify/components/payment_processing/app/experiments/default_to_shop_pay_branded_button_on_pdp_v4.rb	payment_processing
OrderPayment::Inputs::CardDetails	../shopify/components/payment_processing/app/models/order_payment/inputs/card_details.rb	payment_processing
OrderPayment::Inputs::Input	../shopify/components/payment_processing/app/models/order_payment/inputs/input.rb	payment_processing
OrderPayment::Inputs::PaypalDetails	../shopify/components/payment_processing/app/models/order_payment/inputs/paypal_details.rb	payment_processing
OrderPayment::Inputs::RequestDetails	../shopify/components/payment_processing/app/models/order_payment/inputs/request_details.rb	payment_processing
OrderPayment::NextAction	../shopify/components/payment_processing/app/models/order_payment/next_action.rb	payment_processing
OrderPayment::Payment	../shopify/components/payment_processing/app/models/order_payment/payment.rb	payment_processing
PaymentsApi::Inputs::Metafield	../shopify/components/payment_processing/payments_api/app/public/payments_api/inputs/metafield.rb	payment_processing
PaymentsApi::PaymentMethodGatewayInterface::OverridableParameters	../shopify/components/payment_processing/payments_api/app/public/payments_api/payment_method_gateway_interface.rb	payment_processing
PaymentsPartners::EncryptionCertificate	../shopify/components/payment_processing/payments_partners/app/models/payments_partners/encryption_certificate.rb	payment_processing
PaymentsPartners::Metafield	../shopify/components/payment_processing/payments_partners/app/models/payments_partners/metafield.rb	payment_processing
Payments::PaymentFlexibility::PaymentTerms::CreatePaymentTerms::Input	../shopify/components/payments/payment_flexibility/app/public/payments/payment_flexibility/payment_terms/create_payment_terms.rb	payments
Payments::PaymentFlexibility::PaymentTerms::Inputs::PaymentScheduleAttributes	../shopify/components/payments/payment_flexibility/app/public/payments/payment_flexibility/payment_terms/inputs/payment_schedule_attributes.rb	payments
Payments::PaymentFlexibility::PaymentTerms::Inputs::PaymentTermsAttributes	../shopify/components/payments/payment_flexibility/app/public/payments/payment_flexibility/payment_terms/inputs/payment_terms_attributes.rb	payments
Payments::PaymentFlexibility::PaymentTerms::Inputs::PaymentTermsUpdateAttributes	../shopify/components/payments/payment_flexibility/app/public/payments/payment_flexibility/payment_terms/inputs/payment_terms_update_attributes.rb	payments
Payments::PaymentFlexibility::PaymentTerms::Outputs::PaymentTermsResult	../shopify/components/payments/payment_flexibility/app/public/payments/payment_flexibility/payment_terms/outputs/payment_terms_result.rb	payments
Payments::PaymentFlexibility::PaymentTerms::UpdatePaymentTerms::Input	../shopify/components/payments/payment_flexibility/app/public/payments/payment_flexibility/payment_terms/update_payment_terms.rb	payments
Pagination::QueryFilterParamsDescription	../shopify/components/platform/app/models/pagination/query_filter_params_description.rb	platform
AuditEvents::AdminApiEvent	../shopify/components/platform/audit_events/app/models/audit_events/admin_api_event.rb	platform
Pricing::DiscountReservation::SourceUniqueId	../shopify/components/pricing/app/models/pricing/discount_reservation.rb	pricing
Retail::AddonSubscriptionPriceSummary::DiscountPercentage	../shopify/components/retail/app/models/retail/addon_subscription_price_summary.rb	retail
Retail::AddonSubscriptionPriceSummary::DiscountAmount	../shopify/components/retail/app/models/retail/addon_subscription_price_summary.rb	retail
Retail::AddonSubscriptionPriceSummary::LineItem	../shopify/components/retail/app/models/retail/addon_subscription_price_summary.rb	retail
Retail::AddonSubscriptionPriceSummary::PriceChangeTrialExpiration	../shopify/components/retail/app/models/retail/addon_subscription_price_summary.rb	retail
Retail::AddonSubscriptionPriceSummary::PriceChangeDiscountExpiration	../shopify/components/retail/app/models/retail/addon_subscription_price_summary.rb	retail
StoredValue::DerivedLedgerCollection::ConcretionResult	../shopify/components/stored_value_instruments/stored_value/app/models/stored_value/derived_ledger_collection.rb	stored_value_instruments
StoredValue::DerivedLedgerCollection::Entry	../shopify/components/stored_value_instruments/stored_value/app/models/stored_value/derived_ledger_collection.rb	stored_value_instruments
StoredValue::DerivedLedgerCollection::Result	../shopify/components/stored_value_instruments/stored_value/app/models/stored_value/derived_ledger_collection.rb	stored_value_instruments
StoredValue::ExpiringAmount	../shopify/components/stored_value_instruments/stored_value/app/models/stored_value/expiring_amount.rb	stored_value_instruments
StoredValue::ExpiringAmountStack::DeductionSource	../shopify/components/stored_value_instruments/stored_value/app/models/stored_value/expiring_amount_stack.rb	stored_value_instruments
StoredValue::ExpiringAmountStack::Deduction	../shopify/components/stored_value_instruments/stored_value/app/models/stored_value/expiring_amount_stack.rb	stored_value_instruments
StoredValue::ExpiringAmountStack::Expiration	../shopify/components/stored_value_instruments/stored_value/app/models/stored_value/expiring_amount_stack.rb	stored_value_instruments
StoredValue::ImmutableLedgerEntry	../shopify/components/stored_value_instruments/stored_value/app/models/stored_value/immutable_ledger_entry.rb	stored_value_instruments
StoredValue::RevertDebit::RevertPot	../shopify/components/stored_value_instruments/stored_value/app/operations/stored_value/revert_debit.rb	stored_value_instruments
